#####################
#P    #   # #   #   #
# ### # # # # # # # #
#   # # # #   #   # #
# ### # # ##### # # #
#   #   # #     # # #
### ### # ####### # #
# #               # #
# # # ####### # # # #
#   #     #   #P#   #
##### ### # # #######
#     #   # #       #
# ##### ### ####### #
# #   #     #       #
# # # # ##### ## ####
# # #       # #     #
# # #######   ### # #
#     #   # #   # # #
### # # # ##### # # #
#   #   #         # P
#####################